#################
#   #           #
# # # ### ##### #
#               #
#               #
#               #
#               #
#               #
#               #
#               #
#               #
#               #
#               #
#               #
#               #
#               #
#################
